1 1 1 1 1 1 1 1 1 1 1 1 1 1 1 1 1 1 1 1 1 1 1 1 1 1 1 1 1 1 1 1 1 1 1 1 1 1 1 1 1 28 0 0 0 27 1 1 1 1 
1 1 1 1 1 1 1 1 1 1 1 1 1 1 1 1 1 1 1 1 1 1 1 1 1 1 1 1 1 1 1 1 1 1 1 1 1 1 1 1 1 28 0 0 0 27 1 1 1 1 
1 1 1 1 1 1 1 1 1 1 1 1 1 1 1 1 1 1 1 1 1 1 1 1 1 1 1 1 1 1 1 1 1 1 1 1 1 1 1 1 1 28 52 0 0 27 1 1 1 1 
1 1 1 1 1 1 1 1 1 1 1 1 1 1 1 1 1 1 1 1 1 1 1 1 1 1 1 1 1 1 1 1 1 1 1 1 1 1 1 1 1 45 17 0 15 46 1 1 1 1 
1 1 1 1 1 1 1 1 1 1 1 1 1 1 1 1 1 1 1 1 1 1 1 1 1 1 1 1 1 1 1 1 1 1 1 1 1 1 1 1 1 1 28 0 27 1 1 1 1 1 
1 1 1 1 1 1 1 1 1 1 1 1 1 1 1 1 1 1 1 1 1 1 1 1 1 1 1 1 1 1 1 1 1 1 1 1 1 1 1 1 1 1 28 0 27 1 1 1 1 1 
1 1 1 1 1 1 1 1 1 1 1 1 1 1 1 1 1 1 1 1 1 1 1 1 1 1 1 1 1 1 1 1 1 1 1 1 1 1 1 1 1 1 28 0 27 1 1 1 1 1 
1 1 1 1 1 1 1 1 1 1 28 4 4 4 4 4 4 4 4 4 4 4 4 4 4 4 4 4 4 4 4 4 4 4 4 4 4 4 4 4 4 4 4 0 27 1 1 1 1 1 
1 1 1 1 1 1 1 1 1 1 28 49 49 49 49 49 49 49 49 49 49 49 49 49 49 49 49 49 49 49 49 49 49 49 49 49 49 49 49 49 49 49 49 0 27 1 1 1 1 1 
1 1 1 1 1 1 1 1 1 1 28 0 15 16 16 16 16 16 16 16 16 16 16 16 16 16 16 16 16 16 16 16 17 0 15 16 16 16 16 16 16 16 16 16 46 1 28 4 27 1 
1 1 1 1 1 1 1 1 28 4 5 0 3 4 4 27 1 1 1 1 1 1 1 1 1 1 1 1 1 1 1 1 28 0 27 1 1 1 1 1 1 1 1 1 28 4 4 49 4 27 
1 1 1 1 1 1 28 4 4 49 49 0 49 49 49 4 4 27 1 1 1 1 1 1 1 1 1 1 1 1 1 1 28 0 27 1 1 1 1 1 1 1 1 28 4 49 49 0 49 27 
1 1 1 1 28 4 4 49 49 0 0 0 0 0 0 49 49 4 4 27 1 1 1 1 1 1 1 1 1 1 1 1 28 0 27 1 1 1 1 1 1 1 1 28 49 0 0 52 0 27 
1 1 1 28 4 49 49 0 0 0 0 0 0 0 0 0 0 49 49 4 27 1 1 1 1 1 1 1 1 1 1 1 28 0 27 1 1 1 1 1 1 1 1 28 0 15 16 16 16 46 
1 1 1 28 49 0 0 0 0 0 0 0 0 0 0 0 0 0 0 49 27 1 1 1 1 1 1 1 1 1 1 1 28 0 27 1 1 1 1 1 1 1 1 45 16 46 1 1 1 1 
1 1 28 4 0 0 0 0 0 0 0 0 0 0 0 0 0 0 0 0 4 27 1 1 1 1 1 1 1 1 1 1 28 0 27 1 1 1 1 1 1 1 1 1 1 1 1 1 1 1 
1 1 28 49 0 0 0 0 0 0 0 0 0 0 0 0 0 0 0 0 49 27 1 1 1 1 28 4 4 26 4 27 28 0 27 1 1 1 1 1 1 1 1 1 1 1 1 1 1 1 
1 28 4 0 0 0 0 0 0 0 0 0 0 0 0 0 0 0 0 0 0 4 27 1 1 28 4 49 49 4 49 4 5 0 3 4 27 1 1 1 1 1 1 1 1 1 1 1 1 1 
1 28 49 0 0 0 0 0 0 0 0 0 0 0 0 0 0 0 0 0 0 49 27 1 1 28 49 0 0 0 0 49 49 0 49 49 27 1 1 1 1 1 1 1 1 1 1 1 1 1 
1 28 0 0 0 0 0 0 0 0 0 0 0 0 0 0 0 0 0 0 0 0 27 1 1 28 0 0 0 0 0 0 0 0 0 0 27 1 1 1 1 1 1 1 1 1 1 1 1 1 
1 45 17 0 0 0 0 0 0 0 0 0 0 0 0 0 0 0 0 0 0 6 4 4 4 5 0 0 0 0 0 0 0 0 0 15 46 1 1 1 1 1 1 1 1 1 1 1 1 1 
1 1 28 0 0 0 0 0 0 0 0 0 0 0 0 0 0 0 0 0 0 26 49 49 49 49 0 0 0 0 0 0 0 0 0 4 27 1 1 1 1 1 1 1 1 1 1 1 1 1 
1 1 45 17 0 0 0 0 0 0 0 0 0 0 0 0 0 0 0 0 15 44 0 15 16 17 0 0 0 0 0 0 0 0 0 49 27 1 1 1 1 1 1 1 1 1 1 1 1 1 
1 1 1 28 0 0 0 0 0 0 0 0 0 0 0 0 0 0 0 0 27 28 0 27 1 28 0 0 0 0 0 0 0 0 0 0 27 1 1 1 1 1 1 1 1 1 1 1 1 1 
1 1 1 45 17 0 0 0 0 0 0 0 0 0 0 0 0 0 0 15 46 28 0 27 1 45 16 17 0 0 0 0 0 0 0 15 46 1 1 1 1 1 1 1 1 1 1 1 1 1 
1 1 1 1 45 16 16 16 17 0 0 0 0 0 0 0 0 15 16 46 1 28 0 27 1 1 28 4 0 0 0 0 0 0 0 4 27 1 1 1 1 1 1 1 1 1 1 1 1 1 
1 1 1 1 1 1 1 1 45 16 16 16 16 16 16 16 16 46 1 1 1 28 0 27 1 33 40 49 0 0 0 0 0 0 0 49 27 1 1 1 1 1 1 1 1 1 1 1 1 1 
1 1 1 1 1 1 28 4 26 4 4 4 27 1 1 1 1 1 1 1 1 28 0 27 1 28 0 0 0 14 0 0 0 0 0 0 27 1 1 1 1 1 1 1 1 1 1 1 1 1 
1 1 28 4 4 26 4 49 4 49 49 49 4 27 1 1 1 1 1 1 1 28 0 27 1 28 0 0 15 24 17 0 0 0 0 15 46 1 1 1 1 1 1 1 1 1 1 1 1 1 
28 4 4 49 49 4 49 0 49 0 0 0 49 4 27 1 1 1 1 1 1 28 0 27 1 45 16 16 46 1 45 16 16 16 16 46 1 1 1 1 1 1 1 1 1 1 1 1 1 1 
28 49 49 0 0 49 0 0 0 0 0 0 0 49 4 4 27 1 1 1 1 28 0 27 1 1 1 1 1 1 1 1 1 1 1 1 1 1 1 1 28 4 4 27 1 1 1 1 1 1 
28 0 0 0 0 0 0 0 0 0 0 0 0 0 49 49 27 1 1 1 1 28 0 27 1 1 1 1 1 1 1 1 1 1 1 1 1 1 1 28 4 49 49 27 1 1 1 1 1 1 
28 0 0 0 0 0 0 0 0 0 0 0 0 0 0 0 27 1 1 1 1 28 0 27 1 1 1 1 1 1 1 1 1 1 1 1 1 1 1 28 49 0 0 27 1 1 1 1 1 1 
28 0 0 0 0 0 0 0 0 0 0 0 0 0 0 15 46 1 1 1 1 28 0 27 1 1 1 1 1 1 1 1 1 1 1 1 1 1 28 4 0 0 0 27 1 1 1 1 1 1 
28 0 0 0 0 0 0 0 0 0 0 0 0 0 0 4 4 4 4 4 4 5 0 3 4 4 4 4 4 4 4 27 1 1 1 1 1 1 28 49 0 0 15 46 1 1 1 1 1 1 
45 17 0 0 0 0 0 0 0 0 0 0 0 0 0 49 49 49 49 49 49 49 0 49 49 49 49 49 49 49 49 4 27 1 1 1 1 1 45 16 16 16 46 1 1 1 1 1 1 1 
28 4 0 0 0 0 0 0 0 0 0 0 0 0 0 0 15 16 16 16 16 16 16 16 16 16 16 16 17 0 0 49 4 27 1 1 1 1 1 1 1 1 1 1 1 1 1 1 1 1 
28 49 0 0 0 0 0 0 0 0 0 0 0 0 0 0 27 1 1 1 1 1 1 1 1 1 1 1 45 17 0 0 49 4 4 27 1 1 1 1 1 1 1 1 1 1 1 1 1 1 
28 0 0 0 0 0 0 0 0 0 0 0 0 0 0 0 27 1 1 1 1 1 1 1 1 1 1 1 1 45 17 0 0 49 49 4 27 1 1 1 1 1 1 1 1 1 1 1 1 1 
45 17 0 0 0 0 0 0 0 0 0 0 0 0 0 0 27 1 1 1 1 1 1 1 1 1 1 1 1 1 45 17 0 0 0 49 4 27 1 1 1 1 1 1 1 1 1 1 1 1 
1 45 16 17 0 0 0 0 0 0 0 14 0 0 0 0 27 1 1 1 1 1 1 1 1 1 1 1 1 1 1 45 16 17 0 0 49 4 4 4 4 4 4 4 27 1 1 1 1 1 
1 1 1 45 16 16 17 0 0 0 15 24 17 0 15 16 46 1 1 1 1 1 1 1 1 1 1 1 1 1 1 1 1 45 17 0 0 49 49 49 49 49 49 49 4 4 27 1 1 1 
1 1 1 1 1 1 45 16 16 16 46 1 45 16 46 1 1 1 1 1 1 1 1 1 1 1 1 1 1 1 1 1 1 1 45 17 0 0 0 0 0 0 0 0 49 49 4 27 1 1 
1 1 1 1 1 1 1 1 1 1 1 1 1 1 1 1 1 1 1 1 1 28 4 4 27 1 1 1 1 1 1 1 1 1 1 28 0 0 0 0 0 0 0 0 0 0 49 27 1 1 
1 1 1 1 1 1 1 1 1 1 1 1 1 1 1 1 1 1 1 1 33 40 49 49 27 1 1 1 1 1 1 1 1 1 1 28 0 0 0 0 0 0 0 0 0 0 0 27 1 1 
1 1 1 1 1 28 4 4 27 1 1 1 1 1 1 1 1 1 1 1 28 0 0 15 46 1 1 1 1 1 1 1 1 1 1 28 0 0 0 0 0 0 0 0 0 0 0 27 1 1 
1 1 1 28 4 4 49 49 27 1 1 1 1 1 1 1 1 1 1 1 28 0 15 46 1 1 1 1 1 1 1 1 1 1 1 28 0 0 0 0 0 0 0 0 0 0 0 27 1 1 
1 1 1 28 49 49 0 15 46 1 1 1 1 1 1 1 1 1 1 1 45 16 46 1 1 1 1 1 1 1 1 1 1 1 1 28 0 0 0 0 0 14 0 0 0 0 15 46 1 1 
1 1 1 45 17 0 0 27 1 1 1 1 1 1 1 1 1 1 1 1 1 1 1 1 1 1 1 1 1 1 1 1 1 1 1 45 16 17 0 52 15 24 17 53 0 15 46 1 1 1 
1 1 1 1 45 16 16 46 1 1 1 1 1 1 1 1 1 1 1 1 1 1 1 1 1 1 1 1 1 1 1 1 1 1 1 1 1 45 16 16 46 1 45 16 16 46 1 1 1 1 
